0,2,4,6,8
1,3,5,7,9
8,0,2,4,6
9,1,3,5,7
6,8,0,2,4